//MAP CONVERTED BY dmm2tgm.py THIS HEADER COMMENT PREVENTS RECONVERSION, DO NOT REMOVE
"a" = (
/obj/structure/bed/chair/bench/ebony{
	dir = 8
	},
/turf/floor/path/herringbone/basalt,
/area/karzerfeste/caves/point_of_interest/dungeon)
"b" = (
/obj/structure/wall_sconce{
	dir = 8
	},
/turf/floor/path/herringbone/basalt,
/area/karzerfeste/caves/point_of_interest/dungeon)
"c" = (
/turf/floor/path/running_bond/basalt,
/area/karzerfeste/caves/point_of_interest/dungeon)
"e" = (
/obj/structure/closet/crate/chest/ebony,
/obj/item/cash/imperial/regalis,
/obj/item/cash/imperial/regalis,
/obj/item/cash/imperial/quin,
/obj/item/cash/imperial/crown,
/obj/item/cash/imperial/crown,
/obj/item/cash/imperial/crown,
/obj/item/cash/imperial/crown,
/obj/item/cash/imperial/crown,
/obj/item/bladed/longsword,
/turf/floor/path/running_bond/basalt,
/area/karzerfeste/caves/point_of_interest/dungeon)
"f" = (
/turf/wall/brick/basalt,
/area/karzerfeste/caves/point_of_interest/dungeon)
"i" = (
/obj/random/hostile/dungeon,
/turf/floor/path/running_bond/basalt,
/area/karzerfeste/caves/point_of_interest/dungeon)
"j" = (
/obj/structure/closet/cabinet/wooden/ebony,
/obj/item/clothing/suit/armor/crafted/leather,
/obj/item/clothing/pants/trousers/braies,
/turf/floor/path/running_bond/basalt,
/area/karzerfeste/caves/point_of_interest/dungeon)
"k" = (
/obj/structure/wall_sconce{
	dir = 4
	},
/turf/floor/path/herringbone/basalt,
/area/karzerfeste/caves/point_of_interest/dungeon)
"n" = (
/obj/structure/closet/crate/chest/ebony,
/obj/item/cash/imperial/regalis,
/obj/item/cash/imperial/quin,
/obj/item/cash/imperial/quin,
/obj/item/cash/imperial/crown,
/obj/item/cash/imperial/crown,
/obj/item/cash/imperial/crown,
/obj/item/cash/imperial/crown,
/obj/item/cash/imperial/crown,
/obj/item/bladed/broadsword,
/turf/floor/path/running_bond/basalt,
/area/karzerfeste/caves/point_of_interest/dungeon)
"p" = (
/turf/wall/natural/dirt,
/area/karzerfeste/caves/point_of_interest/dungeon)
"q" = (
/turf/template_noop,
/area/karzerfeste/caves/point_of_interest/dungeon)
"s" = (
/obj/structure/bed/simple/ebony,
/turf/floor/path/running_bond/basalt,
/area/karzerfeste/caves/point_of_interest/dungeon)
"w" = (
/obj/structure/door/ebony,
/turf/floor/path/herringbone/basalt,
/area/karzerfeste/caves/point_of_interest/dungeon)
"x" = (
/obj/structure/door/ebony,
/turf/floor/path/herringbone/basalt,
/area/karzerfeste/caves/point_of_interest/dungeon)
"A" = (
/obj/structure/bed/chair/bench/ebony{
	dir = 8
	},
/obj/item/stack/medical/bandage/crafted/five,
/turf/floor/path/herringbone/basalt,
/area/karzerfeste/caves/point_of_interest/dungeon)
"B" = (
/turf/floor/path/herringbone/basalt,
/area/karzerfeste/caves/point_of_interest/dungeon)
"G" = (
/obj/structure/closet/cabinet/wooden/ebony,
/obj/item/clothing/suit/armor/crafted/copper,
/obj/item/clothing/pants/trousers/braies,
/turf/floor/path/running_bond/basalt,
/area/karzerfeste/caves/point_of_interest/dungeon)
"I" = (
/obj/structure/bed/chair/bench/ebony{
	dir = 4
	},
/obj/item/stack/material/bolt/mapped/cloth/five,
/turf/floor/path/herringbone/basalt,
/area/karzerfeste/caves/point_of_interest/dungeon)
"K" = (
/obj/structure/closet/crate/chest/ebony,
/obj/item/cash/imperial/quin,
/obj/item/cash/imperial/quin,
/obj/item/cash/imperial/quin,
/obj/item/cash/imperial/quin,
/obj/item/cash/imperial/quin,
/obj/item/cash/imperial/crown,
/obj/item/cash/imperial/crown,
/obj/item/cash/imperial/crown,
/obj/item/bladed/longsword,
/obj/item/bladed/poignard,
/turf/floor/path/running_bond/basalt,
/area/karzerfeste/caves/point_of_interest/dungeon)
"L" = (
/obj/structure/wall_sconce{
	dir = 1;
	pixel_y = 10
	},
/turf/floor/path/running_bond/basalt,
/area/karzerfeste/caves/point_of_interest/dungeon)
"O" = (
/obj/structure/bed/chair/bench/ebony{
	dir = 8
	},
/obj/item/food/grown/dried_tobacco/bad,
/obj/item/rock/flint/striker,
/turf/floor/path/herringbone/basalt,
/area/karzerfeste/caves/point_of_interest/dungeon)
"P" = (
/obj/structure/closet/cabinet/wooden/ebony,
/obj/item/clothing/suit/armor/forged/banded,
/obj/item/clothing/pants/trousers/braies,
/turf/floor/path/running_bond/basalt,
/area/karzerfeste/caves/point_of_interest/dungeon)
"Q" = (
/obj/item/stack/material/plank/mapped/ebony/five,
/turf/floor/path/running_bond/basalt,
/area/karzerfeste/caves/point_of_interest/dungeon)
"R" = (
/obj/structure/bed/chair/bench/ebony{
	dir = 8
	},
/obj/item/bladed/folding,
/turf/floor/path/herringbone/basalt,
/area/karzerfeste/caves/point_of_interest/dungeon)
"U" = (
/obj/structure/bed/chair/bench/ebony{
	dir = 4
	},
/obj/item/food/grown/dried_tobacco/bad,
/turf/floor/path/herringbone/basalt,
/area/karzerfeste/caves/point_of_interest/dungeon)
"X" = (
/obj/structure/bed/chair/bench/ebony{
	dir = 4
	},
/turf/floor/path/herringbone/basalt,
/area/karzerfeste/caves/point_of_interest/dungeon)
"Z" = (
/obj/structure/bed/chair/bench/ebony{
	dir = 4
	},
/obj/item/stack/medical/bandage/crafted/five,
/turf/floor/path/herringbone/basalt,
/area/karzerfeste/caves/point_of_interest/dungeon)

(1,1,1) = {"
q
q
q
q
q
q
q
q
q
q
q
q
q
q
q
q
q
q
"}
(2,1,1) = {"
q
f
x
x
f
f
f
f
f
f
f
f
f
f
f
f
f
q
"}
(3,1,1) = {"
q
f
c
c
f
c
Q
s
f
n
c
s
f
K
c
s
f
q
"}
(4,1,1) = {"
q
f
c
c
f
L
c
c
f
L
c
c
f
L
c
c
f
q
"}
(5,1,1) = {"
q
f
c
c
f
c
c
P
f
c
c
j
f
c
c
G
f
q
"}
(6,1,1) = {"
q
f
L
c
f
f
x
f
f
f
x
f
f
f
x
f
f
q
"}
(7,1,1) = {"
q
f
c
c
f
B
B
B
b
B
B
B
b
B
B
B
f
q
"}
(8,1,1) = {"
q
f
c
c
w
B
c
c
i
c
c
c
i
c
c
B
f
q
"}
(9,1,1) = {"
q
f
c
c
w
B
c
c
c
c
c
c
c
c
c
B
f
q
"}
(10,1,1) = {"
q
f
c
c
f
B
a
R
B
B
O
A
B
B
a
a
f
q
"}
(11,1,1) = {"
q
f
L
c
f
f
f
f
f
f
f
f
f
f
f
f
f
q
"}
(12,1,1) = {"
q
f
c
c
f
B
X
X
B
B
I
X
B
B
U
Z
f
q
"}
(13,1,1) = {"
q
f
c
c
w
B
c
c
c
c
c
c
c
i
c
B
f
q
"}
(14,1,1) = {"
q
f
c
c
w
B
c
c
c
i
c
c
c
c
c
B
p
q
"}
(15,1,1) = {"
q
f
L
c
f
B
B
B
k
B
B
B
k
p
B
p
p
q
"}
(16,1,1) = {"
q
f
c
c
f
f
x
f
f
f
x
f
f
f
p
p
p
q
"}
(17,1,1) = {"
q
f
c
c
f
Q
c
j
f
c
c
j
f
p
p
p
p
q
"}
(18,1,1) = {"
q
f
c
c
f
L
c
p
p
L
p
p
p
p
p
p
p
q
"}
(19,1,1) = {"
q
f
c
c
f
e
c
s
p
p
p
p
p
p
c
s
f
q
"}
(20,1,1) = {"
q
f
x
x
f
f
f
f
p
p
p
p
p
f
f
f
f
q
"}
(21,1,1) = {"
q
q
q
q
q
q
q
q
q
q
q
q
q
q
q
q
q
q
"}
