//MAP CONVERTED BY dmm2tgm.py THIS HEADER COMMENT PREVENTS RECONVERSION, DO NOT REMOVE
"a" = (
/turf/wall/brick/basalt,
/area/karzerfeste/caves/point_of_interest/dungeon/hallway)
"h" = (
/turf/template_noop,
/area/template_noop)
"l" = (
/turf/floor/path/basalt/water,
/area/karzerfeste/caves/point_of_interest/dungeon/hallway)
"t" = (
/turf/floor/path/running_bond/basalt,
/area/karzerfeste/caves/point_of_interest/dungeon/hallway)
"u" = (
/obj/random/hostile/dungeon,
/turf/floor/path/basalt/water/deep,
/area/karzerfeste/caves/point_of_interest/dungeon/hallway)
"v" = (
/turf/floor/path/basalt/water/deep,
/area/karzerfeste/caves/point_of_interest/dungeon/hallway)
"E" = (
/mob/living/simple_animal/aquatic/fish/grump,
/turf/floor/path/basalt/water/deep,
/area/karzerfeste/caves/point_of_interest/dungeon/hallway)

(1,1,1) = {"
h
h
h
a
a
a
a
h
h
h
h
h
h
a
a
h
"}
(2,1,1) = {"
h
h
t
t
t
t
t
t
h
h
h
t
t
t
t
t
"}
(3,1,1) = {"
l
l
l
l
l
l
l
l
l
l
l
l
l
l
l
l
"}
(4,1,1) = {"
h
h
E
v
v
v
v
u
v
v
v
E
v
v
v
v
"}
(5,1,1) = {"
h
h
h
h
l
l
l
l
l
l
l
l
l
l
l
h
"}
(6,1,1) = {"
h
h
t
t
t
t
t
t
t
t
t
t
t
t
h
h
"}
(7,1,1) = {"
h
h
h
h
a
a
a
a
a
a
a
a
h
h
h
h
"}
