//MAP CONVERTED BY dmm2tgm.py THIS HEADER COMMENT PREVENTS RECONVERSION, DO NOT REMOVE
"a" = (
/turf/template_noop,
/area/karzerfeste/caves/point_of_interest/dungeon)
"b" = (
/turf/wall/natural/dirt,
/area/karzerfeste/caves/point_of_interest/dungeon)
"j" = (
/turf/wall/brick/basalt,
/area/karzerfeste/caves/point_of_interest/dungeon)
"l" = (
/obj/structure/fire_source/stove,
/obj/effect/decal/cleanable/ash,
/turf/floor/path/basalt,
/area/karzerfeste/caves/point_of_interest/dungeon)
"o" = (
/obj/structure/reagent_dispensers/barrel/ebony/water,
/turf/floor/path/basalt,
/area/karzerfeste/caves/point_of_interest/dungeon)
"p" = (
/obj/item/stack/material/plank/mapped/ebony/five,
/turf/floor/path/basalt,
/area/karzerfeste/caves/point_of_interest/dungeon)
"s" = (
/obj/structure/table/wood/reinforced/ebony,
/obj/item/knife/kitchen/cleaver/bronze,
/turf/floor/path/basalt,
/area/karzerfeste/caves/point_of_interest/dungeon)
"w" = (
/obj/structure/wall_sconce,
/turf/floor/path/basalt,
/area/karzerfeste/caves/point_of_interest/dungeon)
"O" = (
/obj/structure/wall_sconce{
	dir = 1;
	pixel_y = 10
	},
/turf/floor/path/basalt,
/area/karzerfeste/caves/point_of_interest/dungeon)
"P" = (
/turf/floor/path/basalt,
/area/karzerfeste/caves/point_of_interest/dungeon)
"S" = (
/obj/structure/table/wood/reinforced/ebony,
/turf/floor/path/basalt,
/area/karzerfeste/caves/point_of_interest/dungeon)
"U" = (
/obj/structure/reagent_dispensers/barrel/ebony/oil,
/turf/floor/path/basalt,
/area/karzerfeste/caves/point_of_interest/dungeon)
"X" = (
/obj/structure/reagent_dispensers/barrel/ebony,
/turf/floor/path/basalt,
/area/karzerfeste/caves/point_of_interest/dungeon)
"Y" = (
/obj/structure/door/ebony,
/turf/floor/path/herringbone/basalt,
/area/karzerfeste/caves/point_of_interest/dungeon)

(1,1,1) = {"
a
a
b
b
a
a
a
a
"}
(2,1,1) = {"
a
b
b
b
b
j
j
a
"}
(3,1,1) = {"
a
j
b
X
b
b
j
a
"}
(4,1,1) = {"
a
j
U
P
b
b
j
a
"}
(5,1,1) = {"
a
j
o
p
P
b
j
a
"}
(6,1,1) = {"
b
j
P
P
P
s
j
b
"}
(7,1,1) = {"
b
j
P
P
P
S
j
b
"}
(8,1,1) = {"
b
b
l
P
P
o
j
b
"}
(9,1,1) = {"
b
j
O
P
P
w
j
b
"}
(10,1,1) = {"
a
j
S
P
P
S
j
b
"}
(11,1,1) = {"
a
j
S
P
P
S
j
a
"}
(12,1,1) = {"
a
j
j
Y
Y
j
j
a
"}
(13,1,1) = {"
a
a
b
a
a
a
a
a
"}
