//MAP CONVERTED BY dmm2tgm.py THIS HEADER COMMENT PREVENTS RECONVERSION, DO NOT REMOVE
"a" = (
/turf/template_noop,
/area/karzerfeste/caves/point_of_interest/dungeon)
"b" = (
/obj/structure/door/ebony,
/turf/floor/path/herringbone/basalt,
/area/karzerfeste/caves/point_of_interest/dungeon)
"e" = (
/obj/structure/wall_sconce{
	dir = 1;
	pixel_y = 10
	},
/turf/floor/path/running_bond/basalt,
/area/karzerfeste/caves/point_of_interest/dungeon)
"h" = (
/turf/floor/path/running_bond/basalt,
/area/karzerfeste/caves/point_of_interest/dungeon)
"n" = (
/obj/structure/closet/crate/chest/ebony,
/obj/item/stack/medical/ointment/crafted/five,
/obj/item/stack/medical/ointment/crafted/five,
/turf/floor/path/running_bond/basalt,
/area/karzerfeste/caves/point_of_interest/dungeon)
"x" = (
/obj/structure/table/wood/reinforced/ebony/walnut,
/obj/item/ancient_surgery/cautery,
/obj/item/ancient_surgery/scalpel,
/turf/floor/path/running_bond/basalt,
/area/karzerfeste/caves/point_of_interest/dungeon)
"A" = (
/obj/structure/table/wood/reinforced/ebony/walnut,
/obj/item/ancient_surgery/bonesaw,
/turf/floor/path/running_bond/basalt,
/area/karzerfeste/caves/point_of_interest/dungeon)
"B" = (
/obj/item/stack/material/plank/mapped/ebony/five,
/obj/structure/closet/crate/chest/ebony,
/obj/item/stack/medical/bandage/crafted/five,
/obj/item/stack/medical/bandage/crafted/five,
/turf/floor/path/running_bond/basalt,
/area/karzerfeste/caves/point_of_interest/dungeon)
"G" = (
/obj/structure/table/wood/reinforced/ebony/walnut,
/obj/item/remains/human,
/turf/floor/path/running_bond/basalt,
/area/karzerfeste/caves/point_of_interest/dungeon)
"J" = (
/turf/wall/brick/basalt,
/area/karzerfeste/caves/point_of_interest/dungeon)
"M" = (
/obj/item/stack/material/plank/mapped/ebony/five,
/turf/floor/path/running_bond/basalt,
/area/karzerfeste/caves/point_of_interest/dungeon)
"O" = (
/obj/structure/table/wood/reinforced/ebony/walnut,
/turf/floor/path/running_bond/basalt,
/area/karzerfeste/caves/point_of_interest/dungeon)
"P" = (
/obj/item/stack/material/bolt/mapped/cloth/five,
/turf/floor/path/running_bond/basalt,
/area/karzerfeste/caves/point_of_interest/dungeon)
"Q" = (
/obj/structure/table/wood/reinforced/ebony/walnut,
/obj/item/ancient_surgery/forceps,
/obj/item/ancient_surgery/retractor,
/turf/floor/path/running_bond/basalt,
/area/karzerfeste/caves/point_of_interest/dungeon)
"V" = (
/obj/structure/wall_sconce{
	dir = 8
	},
/obj/structure/table/wood/reinforced/ebony/walnut,
/obj/item/ancient_surgery/bonesetter,
/obj/item/ancient_surgery/sutures,
/turf/floor/path/running_bond/basalt,
/area/karzerfeste/caves/point_of_interest/dungeon)
"Y" = (
/turf/wall/natural/dirt,
/area/karzerfeste/caves/point_of_interest/dungeon)

(1,1,1) = {"
a
a
a
a
a
a
a
a
"}
(2,1,1) = {"
a
J
J
J
J
J
J
a
"}
(3,1,1) = {"
a
J
A
V
x
Q
J
a
"}
(4,1,1) = {"
a
J
h
h
h
h
J
a
"}
(5,1,1) = {"
a
J
e
O
h
n
J
a
"}
(6,1,1) = {"
a
b
h
G
h
B
J
a
"}
(7,1,1) = {"
a
b
h
h
h
P
J
a
"}
(8,1,1) = {"
a
J
h
h
h
M
Y
a
"}
(9,1,1) = {"
a
J
h
Y
Y
Y
Y
a
"}
(10,1,1) = {"
a
J
Y
Y
Y
Y
Y
a
"}
(11,1,1) = {"
a
J
J
J
J
J
J
a
"}
(12,1,1) = {"
a
a
a
a
a
a
a
a
"}
