//MAP CONVERTED BY dmm2tgm.py THIS HEADER COMMENT PREVENTS RECONVERSION, DO NOT REMOVE
"a" = (
/turf/wall/natural/dirt,
/area/karzerfeste/caves/point_of_interest/dungeon)
"e" = (
/obj/random/hostile/dungeon,
/turf/floor/path/running_bond/basalt,
/area/karzerfeste/caves/point_of_interest/dungeon)
"h" = (
/obj/random/dungeon_bookcase,
/turf/floor/path/running_bond/basalt,
/area/karzerfeste/caves/point_of_interest/dungeon)
"j" = (
/obj/item/flame/candle,
/obj/structure/table/desk/ebony/right,
/turf/floor/path/running_bond/basalt,
/area/karzerfeste/caves/point_of_interest/dungeon)
"k" = (
/turf/template_noop,
/area/karzerfeste/caves/point_of_interest/dungeon)
"n" = (
/turf/floor/rock/basalt,
/area/karzerfeste/caves/point_of_interest/dungeon)
"o" = (
/obj/structure/table/wood/ebony,
/obj/item/rock/flint/striker,
/turf/floor/path/running_bond/basalt,
/area/karzerfeste/caves/point_of_interest/dungeon)
"p" = (
/obj/structure/door/ebony,
/turf/floor/path/herringbone/basalt,
/area/karzerfeste/caves/point_of_interest/dungeon)
"q" = (
/obj/structure/table/wood/ebony,
/obj/item/flame/torch,
/obj/item/flame/torch,
/turf/floor/path/running_bond/basalt,
/area/karzerfeste/caves/point_of_interest/dungeon)
"E" = (
/obj/structure/wall_sconce{
	dir = 8
	},
/turf/floor/path/running_bond/basalt,
/area/karzerfeste/caves/point_of_interest/dungeon)
"H" = (
/turf/floor/path/running_bond/basalt,
/area/karzerfeste/caves/point_of_interest/dungeon)
"I" = (
/turf/wall/brick/basalt,
/area/karzerfeste/caves/point_of_interest/dungeon)
"K" = (
/obj/structure/table/wood/ebony,
/turf/floor/path/running_bond/basalt,
/area/karzerfeste/caves/point_of_interest/dungeon)
"M" = (
/obj/random/dungeon_bookcase,
/turf/floor/rock/basalt,
/area/karzerfeste/caves/point_of_interest/dungeon)
"S" = (
/obj/structure/table/wood/ebony,
/obj/item/flame/candle,
/turf/floor/path/running_bond/basalt,
/area/karzerfeste/caves/point_of_interest/dungeon)
"U" = (
/obj/item/stool/rustic,
/turf/floor/path/running_bond/basalt,
/area/karzerfeste/caves/point_of_interest/dungeon)
"W" = (
/obj/structure/table/desk/ebony/right,
/turf/floor/path/running_bond/basalt,
/area/karzerfeste/caves/point_of_interest/dungeon)

(1,1,1) = {"
k
k
k
k
k
k
k
k
k
k
k
k
k
k
k
k
k
k
k
k
k
k
k
k
"}
(2,1,1) = {"
k
I
I
I
I
I
I
I
I
I
I
I
I
I
I
I
I
p
p
I
I
I
I
k
"}
(3,1,1) = {"
k
I
j
U
E
H
K
K
H
E
K
S
H
H
K
K
E
H
H
E
H
K
I
k
"}
(4,1,1) = {"
k
I
H
H
H
H
H
H
H
H
H
H
H
H
H
H
H
H
H
H
H
S
I
k
"}
(5,1,1) = {"
k
I
H
H
H
h
h
H
H
h
h
H
H
h
h
H
n
h
h
H
H
q
I
k
"}
(6,1,1) = {"
k
I
W
U
H
h
h
e
H
h
h
n
H
h
h
H
n
n
h
e
H
H
p
k
"}
(7,1,1) = {"
k
I
H
H
H
h
h
H
H
h
h
n
n
H
h
n
a
n
h
H
H
H
p
k
"}
(8,1,1) = {"
k
p
H
H
H
h
h
H
H
h
n
H
H
a
n
H
a
M
n
H
H
o
I
k
"}
(9,1,1) = {"
k
I
W
U
H
H
H
H
H
H
H
a
n
n
H
a
a
a
n
n
H
H
I
k
"}
(10,1,1) = {"
k
I
H
H
H
H
K
S
H
n
a
n
n
n
n
a
a
a
a
n
n
n
I
k
"}
(11,1,1) = {"
k
I
I
I
I
I
I
I
I
a
a
a
n
n
a
a
a
a
a
a
a
I
I
k
"}
(12,1,1) = {"
k
a
a
a
a
a
a
a
a
a
a
a
a
a
a
a
a
a
a
a
a
a
a
k
"}
(13,1,1) = {"
k
k
k
k
k
k
k
k
k
k
k
k
k
k
k
k
k
k
k
k
k
k
k
k
"}
