//MAP CONVERTED BY dmm2tgm.py THIS HEADER COMMENT PREVENTS RECONVERSION, DO NOT REMOVE
"a" = (
/turf/template_noop,
/area/karzerfeste/caves/point_of_interest/dungeon)
"h" = (
/obj/structure/wall_sconce{
	dir = 4
	},
/turf/floor/path/herringbone/basalt,
/area/karzerfeste/caves/point_of_interest/dungeon)
"m" = (
/obj/structure/table/wood/ebony,
/obj/item/tool/pickaxe/iron,
/turf/floor/path/herringbone/basalt,
/area/karzerfeste/caves/point_of_interest/dungeon)
"o" = (
/obj/structure/table/wood/ebony,
/obj/item/stack/material/brick/mapped/graphite/fifteen,
/turf/floor/path/herringbone/basalt,
/area/karzerfeste/caves/point_of_interest/dungeon)
"p" = (
/obj/structure/door/ebony,
/turf/floor/path/herringbone/basalt,
/area/karzerfeste/caves/point_of_interest/dungeon)
"s" = (
/obj/structure/wall_sconce{
	dir = 1;
	pixel_y = 10
	},
/turf/floor/path/herringbone/basalt,
/area/karzerfeste/caves/point_of_interest/dungeon)
"t" = (
/obj/structure/fire_source/kiln/high_temperature,
/turf/floor/path/herringbone/basalt,
/area/karzerfeste/caves/point_of_interest/dungeon)
"u" = (
/obj/structure/table/wood/ebony,
/obj/item/bladed/knife,
/turf/floor/path/herringbone/basalt,
/area/karzerfeste/caves/point_of_interest/dungeon)
"x" = (
/obj/structure/table/wood/ebony,
/turf/floor/path/herringbone/basalt,
/area/karzerfeste/caves/point_of_interest/dungeon)
"y" = (
/turf/wall/brick/basalt,
/area/karzerfeste/caves/point_of_interest/dungeon)
"D" = (
/obj/structure/table/wood/ebony,
/obj/item/bladed/folding,
/turf/floor/path/herringbone/basalt,
/area/karzerfeste/caves/point_of_interest/dungeon)
"E" = (
/obj/structure/table/wood/ebony,
/obj/item/stack/material/ore/diamond,
/obj/item/stack/material/ore/diamond,
/obj/item/stack/material/ore/diamond,
/turf/floor/path/herringbone/basalt,
/area/karzerfeste/caves/point_of_interest/dungeon)
"F" = (
/turf/floor/path/basalt,
/area/karzerfeste/caves/point_of_interest/dungeon)
"M" = (
/turf/floor/path/herringbone/basalt,
/area/karzerfeste/caves/point_of_interest/dungeon)
"O" = (
/turf/floor/path/running_bond/basalt,
/area/karzerfeste/caves/point_of_interest/dungeon)
"P" = (
/obj/structure/wall_sconce{
	dir = 8
	},
/turf/floor/path/herringbone/basalt,
/area/karzerfeste/caves/point_of_interest/dungeon)
"T" = (
/obj/structure/table/wood/ebony,
/obj/item/tool/hammer/sledge,
/turf/floor/path/herringbone/basalt,
/area/karzerfeste/caves/point_of_interest/dungeon)
"W" = (
/obj/random/hostile/dungeon,
/turf/floor/path/herringbone/basalt,
/area/karzerfeste/caves/point_of_interest/dungeon)
"X" = (
/obj/structure/table/wood/ebony,
/obj/item/stack/material/ore/diamond,
/turf/floor/path/herringbone/basalt,
/area/karzerfeste/caves/point_of_interest/dungeon)

(1,1,1) = {"
a
a
a
a
a
a
a
a
a
a
a
a
"}
(2,1,1) = {"
a
y
y
y
y
y
y
y
y
y
y
a
"}
(3,1,1) = {"
a
y
u
x
o
M
P
M
M
x
y
a
"}
(4,1,1) = {"
a
y
M
O
O
O
O
O
O
m
y
a
"}
(5,1,1) = {"
a
y
s
O
W
M
M
t
O
T
y
a
"}
(6,1,1) = {"
a
y
M
O
M
F
F
M
O
M
p
a
"}
(7,1,1) = {"
a
y
M
O
M
F
F
M
O
M
p
a
"}
(8,1,1) = {"
a
y
s
O
M
M
M
t
O
D
y
a
"}
(9,1,1) = {"
a
y
M
O
O
O
O
O
O
x
y
a
"}
(10,1,1) = {"
a
y
X
E
o
M
h
M
M
m
y
a
"}
(11,1,1) = {"
a
y
y
y
y
y
y
y
y
y
y
a
"}
(12,1,1) = {"
a
a
a
a
a
a
a
a
a
a
a
a
"}
