//MAP CONVERTED BY dmm2tgm.py THIS HEADER COMMENT PREVENTS RECONVERSION, DO NOT REMOVE
"a" = (
/mob/living/simple_animal/aquatic/fish/grump,
/turf/floor/path/basalt/water/deep,
/area/karzerfeste/caves/point_of_interest/dungeon)
"c" = (
/turf/floor/path/running_bond/basalt,
/area/karzerfeste/caves/point_of_interest/dungeon)
"d" = (
/obj/structure/door/ebony,
/turf/floor/path/herringbone/basalt,
/area/karzerfeste/caves/point_of_interest/dungeon)
"i" = (
/turf/wall/brick/basalt,
/area/karzerfeste/caves/point_of_interest/dungeon)
"n" = (
/turf/template_noop,
/area/karzerfeste/caves/point_of_interest/dungeon)
"B" = (
/turf/floor/path/basalt/water/deep,
/area/karzerfeste/caves/point_of_interest/dungeon)
"H" = (
/obj/item/remains/human,
/turf/floor/path/running_bond/basalt,
/area/karzerfeste/caves/point_of_interest/dungeon)
"O" = (
/turf/floor/path/herringbone/basalt,
/area/karzerfeste/caves/point_of_interest/dungeon)
"S" = (
/turf/floor/path/basalt/water,
/area/karzerfeste/caves/point_of_interest/dungeon)

(1,1,1) = {"
n
n
n
n
n
n
n
n
n
n
n
n
n
n
n
"}
(2,1,1) = {"
n
i
i
i
i
c
c
c
c
c
i
i
i
i
n
"}
(3,1,1) = {"
n
i
c
c
c
c
c
c
H
c
c
c
c
i
n
"}
(4,1,1) = {"
n
i
c
S
S
S
S
B
S
S
S
S
c
i
n
"}
(5,1,1) = {"
n
i
c
S
B
B
B
B
B
B
B
S
c
i
n
"}
(6,1,1) = {"
n
c
c
S
B
B
B
B
B
a
B
S
c
i
n
"}
(7,1,1) = {"
n
c
c
S
B
B
B
B
B
B
B
S
c
i
n
"}
(8,1,1) = {"
n
c
c
B
B
B
B
B
B
B
B
S
c
i
n
"}
(9,1,1) = {"
n
c
c
S
B
B
B
B
B
B
B
S
c
O
n
"}
(10,1,1) = {"
n
c
c
S
B
B
a
B
B
B
B
S
c
O
n
"}
(11,1,1) = {"
n
i
c
S
B
B
B
B
B
B
B
S
c
i
n
"}
(12,1,1) = {"
n
i
c
S
S
S
S
S
S
S
S
S
c
i
n
"}
(13,1,1) = {"
n
i
c
c
c
c
c
c
c
c
c
c
c
i
n
"}
(14,1,1) = {"
n
i
i
i
i
i
i
d
d
i
i
i
i
i
n
"}
(15,1,1) = {"
n
n
n
n
n
n
n
n
n
n
n
n
n
n
n
"}
