//MAP CONVERTED BY dmm2tgm.py THIS HEADER COMMENT PREVENTS RECONVERSION, DO NOT REMOVE
"a" = (
/turf/wall/brick/basalt,
/area/karzerfeste/caves/point_of_interest/dungeon)
"y" = (
/obj/structure/door/ebony,
/turf/floor/path/herringbone/basalt,
/area/karzerfeste/caves/point_of_interest/dungeon)
"H" = (
/obj/structure/wall_sconce{
	dir = 4
	},
/turf/floor/path/running_bond/basalt,
/area/karzerfeste/caves/point_of_interest/dungeon)
"M" = (
/turf/template_noop,
/area/karzerfeste/caves/point_of_interest/dungeon)
"P" = (
/turf/floor/path/basalt/water/deep,
/area/karzerfeste/caves/point_of_interest/dungeon)
"T" = (
/turf/floor/path/running_bond/basalt,
/area/karzerfeste/caves/point_of_interest/dungeon)
"U" = (
/obj/structure/wall_sconce{
	dir = 8
	},
/turf/floor/path/running_bond/basalt,
/area/karzerfeste/caves/point_of_interest/dungeon)
"V" = (
/turf/floor/path/herringbone/basalt,
/area/karzerfeste/caves/point_of_interest/dungeon)

(1,1,1) = {"
M
M
M
M
M
M
M
M
M
"}
(2,1,1) = {"
M
a
a
a
a
a
a
a
M
"}
(3,1,1) = {"
M
a
T
T
U
T
T
a
M
"}
(4,1,1) = {"
M
a
T
V
V
V
T
a
M
"}
(5,1,1) = {"
M
y
T
V
P
V
T
y
M
"}
(6,1,1) = {"
M
y
T
V
P
V
T
y
M
"}
(7,1,1) = {"
M
a
T
V
V
V
T
a
M
"}
(8,1,1) = {"
M
a
T
T
H
T
T
a
M
"}
(9,1,1) = {"
M
a
a
a
a
a
a
a
M
"}
(10,1,1) = {"
M
M
M
M
M
M
M
M
M
"}
