//MAP CONVERTED BY dmm2tgm.py THIS HEADER COMMENT PREVENTS RECONVERSION, DO NOT REMOVE
"a" = (
/turf/floor/path/running_bond/basalt,
/area/karzerfeste/caves/point_of_interest/dungeon/hallway)
"b" = (
/obj/structure/decoration/gargoyle/random{
	dir = 4
	},
/turf/floor/path/running_bond/basalt,
/area/karzerfeste/caves/point_of_interest/dungeon/hallway)
"h" = (
/turf/wall/brick/basalt,
/area/karzerfeste/caves/point_of_interest/dungeon/hallway)
"J" = (
/obj/structure/decoration/gargoyle/random{
	dir = 8
	},
/turf/floor/path/running_bond/basalt,
/area/karzerfeste/caves/point_of_interest/dungeon/hallway)
"R" = (
/turf/template_noop,
/area/template_noop)

(1,1,1) = {"
R
R
R
h
h
h
h
h
R
R
h
h
h
R
R
R
h
h
R
R
"}
(2,1,1) = {"
R
a
b
a
h
h
a
b
a
h
h
a
b
a
R
R
a
b
a
R
"}
(3,1,1) = {"
a
a
a
a
a
a
a
a
a
a
a
a
a
a
a
a
R
a
a
R
"}
(4,1,1) = {"
a
R
a
a
a
a
a
a
a
a
R
a
a
a
a
a
a
a
a
a
"}
(5,1,1) = {"
R
a
a
a
a
R
R
a
a
a
a
a
a
a
a
a
a
a
R
R
"}
(6,1,1) = {"
h
a
J
a
h
R
a
J
a
h
h
a
J
a
h
h
a
J
a
R
"}
(7,1,1) = {"
h
h
h
h
R
R
h
h
h
h
R
h
h
R
R
h
h
h
R
R
"}
