//MAP CONVERTED BY dmm2tgm.py THIS HEADER COMMENT PREVENTS RECONVERSION, DO NOT REMOVE
"a" = (
/turf/floor/path/running_bond/basalt,
/area/karzerfeste/caves/point_of_interest/dungeon/hallway)
"c" = (
/turf/template_noop,
/area/template_noop)
"o" = (
/turf/floor/path/basalt/water/deep,
/area/karzerfeste/caves/point_of_interest/dungeon/hallway)
"G" = (
/turf/floor/path/basalt/water,
/area/karzerfeste/caves/point_of_interest/dungeon/hallway)
"H" = (
/obj/random/hostile/dungeon,
/turf/floor/path/basalt/water/deep,
/area/karzerfeste/caves/point_of_interest/dungeon/hallway)
"S" = (
/turf/wall/brick/basalt,
/area/karzerfeste/caves/point_of_interest/dungeon/hallway)

(1,1,1) = {"
c
c
G
o
c
c
c
"}
(2,1,1) = {"
c
c
G
o
G
c
S
"}
(3,1,1) = {"
c
a
G
o
G
a
c
"}
(4,1,1) = {"
S
a
G
o
G
a
c
"}
(5,1,1) = {"
S
a
G
o
G
a
S
"}
(6,1,1) = {"
S
a
G
o
G
a
S
"}
(7,1,1) = {"
S
a
G
H
G
a
S
"}
(8,1,1) = {"
S
a
G
o
G
a
c
"}
(9,1,1) = {"
S
a
G
o
G
a
c
"}
(10,1,1) = {"
S
a
G
o
G
a
c
"}
(11,1,1) = {"
c
a
G
o
G
a
c
"}
(12,1,1) = {"
c
a
G
o
G
a
S
"}
(13,1,1) = {"
c
a
G
o
G
a
S
"}
(14,1,1) = {"
c
a
G
o
G
a
S
"}
(15,1,1) = {"
S
a
c
c
c
a
c
"}
(16,1,1) = {"
S
c
c
c
c
a
S
"}
