"a" = (/turf/exterior/sand,/area/pyrelight/outside)
"b" = (/turf/exterior/wildgrass,/area/pyrelight/outside)
"d" = (/turf/exterior/wall,/area/pyrelight/outside)
"h" = (/turf/simulated/wall/walnut,/area/pyrelight/outside)
"i" = (/obj/abstract/landmark/latejoin,/turf/exterior/dirt,/area/pyrelight/outside)
"k" = (/turf/exterior,/area/pyrelight/outside)
"p" = (/obj/structure/railing/mapped,/turf/exterior/concrete/reinforced{color = "#fcf692"},/area/pyrelight/outside)
"s" = (/turf/simulated/floor/wood/yew,/area/pyrelight/outside)
"t" = (/turf/exterior/concrete/reinforced{color = "#fcf692"},/area/pyrelight/outside)
"u" = (/turf/exterior/grass,/area/pyrelight/outside)
"z" = (/obj/structure/railing/mapped{icon_state = "_railing0-1"},/turf/exterior/concrete/reinforced,/area/pyrelight/outside)
"D" = (/turf/simulated/floor/wood/usedup,/area/pyrelight/outside)
"E" = (/turf/exterior/water,/area/pyrelight/outside)
"G" = (/obj/structure/railing/mapped{dir = 1},/turf/exterior/concrete/reinforced,/area/pyrelight/outside)
"L" = (/obj/abstract/landmark/start{name = "Observer-Start"},/turf/exterior/dirt,/area/pyrelight/outside)
"M" = (/obj/structure/railing/mapped{dir = 8},/turf/exterior/concrete/reinforced{color = "#fcf692"},/area/pyrelight/outside)
"N" = (/turf/exterior/dirt,/area/pyrelight/outside)
"Q" = (/obj/structure/railing/mapped{dir = 8},/obj/structure/railing/mapped,/turf/exterior/concrete/reinforced{color = "#fcf692"},/area/pyrelight/outside)
"U" = (/obj/abstract/level_data_spawner/pyrelight,/turf/exterior/water,/area/pyrelight/outside)
"V" = (/turf/simulated/floor/wood/walnut,/area/pyrelight/outside)
"Z" = (/turf/exterior/concrete/reinforced,/area/pyrelight/outside)

(1,1,1) = {"
EEEEEEEEEEEEEEEEaaaaaabbbbbbbbbbbbbbbbbbbbbbbbbbbbbbbbbbbbbbbbbbbbbbbbbbbbbbbbbbbbbbbbbbbbbbbbbbbbbbbbbbbbbbbbbbbbbbbbbb
EEEEEEEEEEEEEEEEaaaaaabbbbbbbbbbbbbbbbbbbbbbbbbbbbbbbbbbbbbbbbbbbbbbbbbbbbbbbbbbbbbbbbbbbbbbbbbbbbbbbbbbbbbbbbbbbbbbbbbb
EEEEEEEEEEEEEEEEaaaaaabbbbbbbbbbbbbbbbbbbbbbbbbbbbbbbbbbbbbbbbbbbbbbbbbbbbbbbbbbbbbbbbbbbbbbbbbbbbbbbbbbbbbbbbbbbbbbbbbb
EEEEEEEEEEEEEEEEaaaaaabbbbbbbbbbbbbbbbbbbbbbbbbbbbbbbbbbbbbbbbbbbbbbbbbbbbbbbbbbbbbbbbbbbbbbbbbbbbbbbbbbbbbbbbbbbbbbbbbb
EEEEEEEEEEEEEEEEaaaaaaabbbbbbbbbbbbbbbbbbbbbbbbbbbbbbbbbbbbbbbbbbbbbbbbbbbbbbbbbbbbbbbbbbbbbbbbbbbbbbbbbbbbbbbbbbbbbbbbb
EEEEEEEEEEEEEEEEEaaaaaabbbbbbbbbbbbbbbbbbbbbbbbbbbbbbbbbbbbbbbbbbbbbbbbbbbbbbbbbbbbbbbbbbbbbbbbbbbbbbbbbbbbbbbbbbbbbbbbb
EEEEEEEEEEEEEEEEEaaaaaabbbbbbbbbbbbbbbbbbbbbbbbbbbbbbbbbbbbbbbbbbbbbbbbbbbbbbbbbbbbbbbbbbbbbbbbbbbbbbbbbbbbbbbbbbbbbbbbb
EEEEEEEEEEEEEEEEEaaaaaabbbbbbbbbbbbbbbbbbbbbbbbbbbbbbbbbbbbbbbbbbbbbbbbbbbbbbbbbbbbbbbbbbbbbbbbbbbbbbbbbbbbbbbbbbbbbbbbb
EEEEEEEEEEEEEEEEEaaaaaabbbbbbbbbbbbbbbbbbbbbbbbbbbbbbbbbbbbbbbbbbbbbbbbbbbbbbbbbbbbbbbbbbbbbbbbbbbbbbbbbbbbbbbbbbbbbbbbb
EEEEEEEEEEEEEEEEEaaaaaabbbbbbbbbbbbbbbbbbbbbbbbbbbbbbbbbbbbbbbbbbbbbbbbbbbbbbbbbbbbbbbbbbbbbbbbbbbbbbbbbbbbbbbbbbbbbbbbb
EEEEEEEEEEEEEEEEEaaaaaabbbbbbbbbbbbbbbbbbbbbbbbbbbbbbbbbbbbbbbbbbbbbbbbbbbbbbbbbbbbbbbbbbbbbbbbbbbbbbbbbbbbbbbbbbbbbbbbb
EEEEEEEEEEEEEEEEEaaaaaaabbbbbbbbbbbbbbbbbbbbbbbbbbbbbbbbbbbbbbbbbbbbbbbbbbbbbbbbbbbbbbbbbbbbbbbbbbbbbbbbbbbbbbbbbbbbbbbb
EEEEEEEEEEEEEEEEEaaaaaaabbbbbbbbbbbbbbbbbbbbbbbbbbbbbbbbbbbbbbbbbbbbbbbbbbbbbbbbbbbbbbbbbbbbbbbbbbbbbbbbbbbbbbbbbbbbbbbb
EEEEEEEEEEEEEEEEEaaaaaaabbbbbbbbbbbbbbbbbbbbbbbbbbbbbbbbbbbbbbbbbbbbbbbbbbbbbbbbbbbbbbbbbbbbbbbbbbbbbbbbbbbbbbbbbbbbbbbb
EEEEEEEEEEEEEEEEEEaaaaaabbbbbbbbbbbbbbbbbbbbbbbbbbbbbbbbbbbbbbbbbbbbbbbbbbbbbbbbbbbbbbbbbbbbbbbbbbbbbbbbbbbbbbbbbbbbbbbb
EEEEEEEEEEEEEEEEEEaaaaaaabbbbbbbbbbbbbbbbbbbbbbbbbbbbbbbbbbbbbbbbbbbbbbbbbbbbbbbbbbbbbbbbbbbbbbbbbbbbbbbbbbbbbbbbbbbbbbb
EEEEEEEEEEEEEEEEEEEaaaaaabbbbbbbbbbbbbbbbbbbbbbbbbbbbbbbbbbbbbbbbbbbbbbbbbbbbbbbbbbbbbbbbbbbbbbbbbbbbbbbbbbbbbbbbbbbbbbb
EEEEEEEEEEEEEEEEEEEaaaaaaabbbbbbbbbbbbbbbbbbbbbbbbbbbbbbbbbbbbbbbbbbbbbbbbbbbbbbbbbbbbbbbbbbbbbbbbbbbbbbbbbbbbbbbbbbbbbb
EEEEEEEEEEEEEEEEEEEaaaaaaabbbbbbbbbbbbbbbbbbbbbbbbbbbbbbbbbbbbbbbbbbbbbbbbbbbbbbbbbbbbbbbbbbbbbbbbbbbbbbbbbbbbbbbbbbbbbb
EEEEEEEEEEEEEEEEEEEaaaaaaaabbbbbbbbbbbbbbbbbbbbbbbbbbbbbbbbbbbbbbbbbbbbbbbbbbbbbbbbbbbbbbbbbbbbbbbbbbbbbbbbbbbbbbbbbbbbb
EEEEEEEEEEEEEEEEEEEaaaaaaaabbbbbbbbbbbbbbbbbbbbbbbbbbbbbbbbbbbbbbbbbbbbbbbbbbbbbbbbbbbbbbbbbbbbbbbbbbbbbbbbbbbbbbbbbbbbb
EEEEEEEEEEEEEEEEEEEEaaaaaaabbbbbbbbbbbbbbbbbbbbbbbbbbbbbbbbbbbbbbbbbbbbbbbbbbbbbbbbbbbbbbbbbbbbbbbbbbbbbbbbbbbbbbbbbbbbb
EEEEEEEEEEEEEEEEEEEEaaaaaaaabbbbbbbbbbbbbbbbbbbbbbbbbbbbbbbbbbbbbbbbbbbbbbbbbbbbbbbbbbbbbbbbbbbbbbbbbbbbbbbbbbbbbbbbbbbb
EEEEEEEEEEEEEEEEEEEEaaaaaaaabbbbbbbbbbbbbbbbbbbbbbbbbbbbbbbbbbbbbbbbbbbbbbbbbbbbbbbbbbbbbbbbbbbbbbbbbbbbbbbbbbbbbbbbbbbb
EEEEEEEEEEEEEEEEEEEEaaaaaaaabbbbbbbbbbbbbbbbbbbbbbbbbbbbbbbbbbbbbbbbbbbbbbbbbbbbbbbbbbbbbbbbbbbbbbbbbbbbbbbbbbbbbbbbbbbb
EEEEEEEEEEEEEEEEEEEEaaaaaaaaabbbbbbbbbbbbbbbbbbbbbbbbbbbbbbbbbbbbbbbbbbbbbbbbbbbbbbbbbbbbbbbbbbbbbbbbbbbbbbbbbbbbbbbbbbb
EEEEEEEEEEEEEEEEEEEEEaaaaaaaabbbbbbbbbbbbbbbbbbbbbbbbbbbbbbbbbbbbbbbbbbbbbbbbbbbbbbbbbbbbbbbbbbbbbbbbbbbbbbbbbbbbbbbbbbb
EEEEEEEEEEEEEEEEEEEEEaaaaaaaabbbbbbbbbbbbbbbbbbbbbbbbbbbbbbbbbbbbbbbbbbbbbbbbbbbbbbbbbbbbbbbbbbbbbbbbbbbbbbbbbbbbbbbbbbb
EEEEEEEEEEEEEEEEEEEEEaaaaaaaaabbbbbbbbbbbbbbbbbbbbbbbbbbbbbbbbbbbbbbbbbbbbbbbbbbbbbbbbbbbbbbbbbbbbbbbbbbbbbbbbbbbbbbbbbb
EEEEEEEEEEEEEEEEEEEEEEaaaaaaaabbbbbbbbbbbbbbbbbbbbbbbbbbbbbbbbbbbbbbbbbbbbbbbbbbbbbbbbbbbbbbbbbbbbbbbbbbbbbbbbbbbbbbbbbb
EEEEEEEEEEEEEEEEEEEEEEaaaaaaaabbbbbbbbbbbbbbbbbbbbbbbbbbbbbbbbbbbbbbbbbbbbbbbbbbbbbbbbbbbbbbbbbbbbbbbbbbbbbbbbbbbbbbbbbb
EEEEEEEEEEEEEEEEEEEEEEaaaaaaaabbbbbbbbbbbbbbbbbbbbbbbbbbbbbbbbbbbbbbbbbbbbbbbbbbbbbbbbbbbbbbbbbbbbbbbbbbbbbbbbbbbbbbbbbb
EEEEEEEEEEEEEEEEEEEEEEaaaaaaaaabbbbbbbbbbbbbbbbbbbbbbbbbbbbbbbbbbbbbbbbbbbbbbbbbbbbbbbbbbbbbbbbbbbbbbbbbbbbbbbbbbbbbbbbb
EEEEEEEEEEEEEEEEEEEEEEEaaaaaaaabbbbbbbbbbbbbbbbbbbbbbbbbbbbbbbbbbbbbbbbbbbbbbbbbbbbbbbbbbbbbbbbbbbbbbbbbbbbbbbbbbbbbbbbb
EEEEEEEEEEEEEEEEEEEEEEEEEEaaaaabbbbbbbbbbbbbbbbbbbbbbbbbbbbbbbbbbbbbbbbbbbbbbbbbbbbbbbbbbbbbbbbbbbbbbbbbbbbbbbbbbbbbbbbb
EEEEEEEEEEEEEEEEEEEEEEEEEEEEEEEEEbbbbbbbbbbbbbbbbbbbbbbbbbbbbbbbbbbbbbbbbbbbbbbbbbbbbbbbbbbbbbbbbbbbbbbbbbbbbbbbbbbbbbbb
EEEEEEEEEEEEEEEEEEEEEEEEEEEEEEEEEEEEEEEEEEEEEEEEEEEEEEEEEEEEEEEEEEEEbbbbbbbbbbbVVbbbbbbbbbbbbbbbbbbbbbbbbbbbbbbbbbbbbbbb
EEEEEEEEEEEEEEEEEEEEEEEEEEEEEEEEEEEEEEEEEEEEEEEEEEEEEEEEEEEEEEEEEEEEEEEEEEEEEEEVVEEEEEEEEEEbbbbbbbbbbbbbbbbbbbbbbbbbbbbb
EEEEEEEEEEEEEEEEEEEEEEEEEEEEEEEEEEEEEEEEEEEEEEEEEEEEEEEEEEEEEEEEEEEEEEEEEEEEEEEVVEEEEEEEEEEEEEEEEEEEEEEEEEEEEEEEEEEEEEEE
EEEEEEEEEEEEEEEEEEEEEEEEEEEEEEEEEEEEEEEbbbbbbbbbbbbbbbbbbbbbbbbbbbbEEEEEEEEEEEEVVEEEEEEEEEEEEEEEEEEEEEEEEEEEEEEEEEEEEEEE
EEEEEEEEEEEEEEEEEEEEEEEEEEEEEEEEEEbbbbbbbbbbbbbbbbbbbbbbbbbbbbbbbbbbbbbbbbbbbbEVVEEEEEEEEEEEEEEEEEEEEEEEEEEEEEEEEEEEEEEE
EEEEEEEEEEEEEEEEEEEEEEEEEEEEEEEaabbbbbbbbbbbbbbbbbbbbbbbbbbbbbbbbbbbbbbbbbbbbbbVVbbbbbbbbbbbbbbbbbbEEEEEEEEEEEEEEEEbbbbb
EEEEEEEEEEEEEEEEEEEEEEEEEEEEEaaaabbbbbbbbbbbbbbbbbbbbbbbbbbbbbbbbbbbbbbbbbbbbbbNNbbbbbbbbbbbbbbbbbbbbbbbbbbbbbbbbbbbbbbb
EEEEEEEEEEEEEEEEEEEEEEEEEaaaaaaaabbbbbbbbbbbbbbbbbbbbbbbbbbbbbbbbbbbbbbbbbbbbbbNNbbbbbbbbbbbbbbbbbbbbbbbbbbbbbbbbbbbbbbb
EEEEEEEEEEEEEEEEEEEEEEEEaaaaaaaaabbbbbbbbbbbbbbbbbbbbbbbbbbbbbbbbbbbbbbbbbbbbbbNNbbbbbbbbbbbbbbbbbbbbbbbbbbbbbbbbbbbbbbb
EEEEEEEEEEEEEEEEEEEEEEEEaaaaaaaaaabbbbbbbbbbbbbbbbbbbbbbbbbbbbbbbbbbbbbbbbbbbbbNNbbbbbbbbbbbbbbbbbbbbbbbbbbbbbbbbbbbbbbb
EEEEEEEEEEEEEEEEEEEEEEEEaaaaaaaaaabbbbbbbbbbbbbbbbbbbbbbbbbbbbbbbbbbbbbbbbbbbbbNNbbbbbhhhhhhbbbbbbbbbbbbbbbbbbbbbbbbbbbb
EEEEEEEEEEEEEEEEEEEEEEEEEEaaaaaaaabbbbbbbbbbbbbbbbbbbbbbbbbbbbbbbbbbbbbbbbbbbbbNNbbbbbhDDDDhbbbbbbbbbbbbbbbbbbbbbbbbbbbb
EEEEEEEEEEEEEEEEEEEEEEEEEEaaaaaaaabbbbbbbbbbbbbbbbbbbbbbbbbbbbbbbbbbbbbbbbbbbbbNNbbbbbhDDDDhbbbbbbbbbbbbbbbbbbbbbbbbbbbb
EEEEEEEEEEEEEEEEEEEEEEEEEEaaaaaaaabbbbbbbbbbbbbbbbbbbbbbbbbbbbbbbbhhhhhhhbbbbbbNNbbbbbhDDDhhhhhhhhhhbbbbbbbbbbbbbbbbbbbb
EEEEEEEEEEEEEEEEEEEEEEEEEEaaaaaaaabbbbbbbbbbbbbbbbbbbbbbbbbbbbbbbbhDDDDDhbbbbbbNNbbbbbhDDDDDDDDDDDDhbbbbbbbbbbbbbbbbbbbb
EEEEEEEEEEEEEEEEEEEEEEEEEEaaaaaaaabbbbbbbbbbbbbbbbbbbbbbbbbbbbbbbbhDDDDDhbuuuuuNNuuuubhDDDhDDDDDDDDhbbbbbbbbbbbbbbbbbbbb
EEEEEEEEEEEEEEEEEEEEEEEEEEaaaaaaaabbbbbbbbbbbbbbbbbbbbbbbbbbbbbbuuhDDDDDhuuuuuuNNuuuuuhhhhhDDDDDDDDhbbbbbbbbbbbbbbbbbbbb
EEEEEEEEEEEEEEEEEEEEEEEEEEaaaaaaabbbbbbbbbbbbbbbbbbbbuuuuuuuuuuuuuhDDDDDhuuuuuNNNuuuuuuuuuhDDDDDDDDhuuubbbbbbbbbbbbbbbbb
EEEEEEEEEEEEEEEEEEEEEEEEEEaaaaaaabbbbbbbbbbbbbuuuuuuuuuuuuuuuuuuuuhhhDhhhuuuuNNNNNuuuuuuuuhhhhDhhhhhuuuuuuuuuuuubbbbbbbb
EEEEEEEEEEEEEEEEEEEEEEEEEEaaaaaaabbbbbbbbbbbuuuuuuuuuuuuuuuuuuuuuuuuuNNNNNNNNNNNNNNNNNNNNNNNNNNuuuuuuuuuuuuuuuuuuuuuuuuu
EEEEEEEEEEEEEEEEEEEEEEEEEEaaaaaaabbbbbbbbbbbuukkkkkkkkkkkkkkkkkkkkkkkkkkkkuuuuNNNNuukkkkkkkkkkkkkkkkkkkkkkkkkkuuuuuuuuuu
EEEEEEEEEEEEEEEEEEEEEEEEEEaaaaaaabbbbbbbbbbuuukkkkkkkkkkkkkkkkkkkkkkkkkkkkuuuuuNNuuukkkkkkkkkkkkkkkkkkkkkkkkkkuuuuuuuuuu
EEEEEEEEEEEEEEEEEEEEEEEEEEaaaaaaabbbbbbbbbuuuukkkkkkkkkkkkkkkkkkkkkkkkkkkkuuuuuNNuuukkkkkkkkkkkkkkkkkkkkkkkkkkuuuuuuuuuu
EEEEEEEEEEEEEEEEEEEEEEEEEEaaaaaaabbbbbbbbuuuuukkkkkkkkkkkkkkkkkkkkkkkkkkkkuuuuuNNuuukkkkkkkkkkkkkkkkkkkkkkkkkkuuuuuuuuuu
EEEEEEEEEEEEEEEEEEEEEEEEEEaaaaaabbbbbbbbbuuuuukkkkkkkkkkkkkkkkkkkkkkkkkkkkuuuuuNNuuukkkkkkkkkkkkkkkkkkkkkkkkkkuuuuuuuuuu
EEEEEEEEEEEEEEEEEEEEEEEEEEaaaaaabbbbbbbbbuuuuukkkkkkkkkkkkkkkkkkkkkkkkkkkkuuuuuNNuuukkkkkkkkkkkkkkkkkkkkkkkkkkuuuuuuuuuu
EEEEEEEEEEEEEEEEEEEEEEEEEEaaaaaabbbbbbbbuuuuuukkkkkkkkkkkkkkkkkkkkkkkkkkkkuuuuuNNuuukkkkkkkkkkkkkkkkkkkkkkkkkkuuuuuuuuuu
EEEEEEEEEEEEEEEEEEEEEEEEEEaaaaaabbbbbbbbuuuuuukkkkkkkkkkkkkkkkkkkkkkkkkkkkuuuuuNNuuukkkkkkkkkkkkkkkkkkkkkkkkkkuuuuuuuuuu
EEEEEEEEEEEEEEEEEEEEEEEEEEaaaaabbbbbbbbuuuuuuukkkkkkkkkkkkkkkkkkkkkkkkkkkkuuuuuNNuuukkkkkkkkkkkkkkkkkkkkkkkkkkuuuuuuuuuN
EEEEEEEEEEEEEEEEEEEEEEEEEEaaaaabbbbbbbbuuuuuuukkkkkkkkkkkkkkkkkkkkkkkkkkkkuuuuuNNuuukkkkkkkkkkkkkkkkkkkkkkkkkkuuuuuuuuNN
EEEEEEEEEEEEEEEEEEEEEEEEEEaaaaabbbbbbbbuuuuuuukkkkkkkkkkkkkkkkkkkkkkkkkkkkuuuuuNNuuukkkkkkkkkkkkkkkkkkkkkkkkkkuuuuuuuNNN
EEEEEEEEEEEEEEEEEEEEEEEEEEaaaaabbbbbbbuuuuuuuukkkkkkkkkkkkkkkkkkkkkkkkkkkkuuuuuNNuuukkkkkkkkkkkkkkkkkkkkkkkkkkuuuuuuNNNN
EEEEEEEEEEEEEEEEEEEEEEEEEEaaaaabbbbbbuuuuuuuuuuuuuuuuuuuuuuuuuuuuuuuuuuuuuuuuNNNNNuuuuuuuuuuuuuuuuuuuuuuuuuuuuuuuuuNNNNu
EEEEEEEEEEEEEEEEEEEEEEEEEEaaaabbbbbbuuuuuuuuuuuuuuuuuuuuuuuuuuuuuuuuuuuuuuNNNNNNNNNNuuuuuuuuuuuuNNNNuuuuuuuuuuuuuNNNNNuu
EEEEEEEEEEEEEEEEEEEEEEEEEEaaaabbbbbbuuuuuuuuuuuuNNNNNNNNNNNNNNNNNNNNNNNNNNNNNNNNNNNNNNNNNNNNNNNNNNNNNuuuuuuuuuuNNNNNNuuu
EEEEEEEEEEEEEEEEEEEEEEEEEEaaaabbbbbuuuuuuuuuuuNNNNNNNNNNNNNNNNNNNNNNNNNNNNNNNNNNNNNNNNNNNNNNNNNNNNNNNNNNNNNNNNNNNNNuuuuu
EEEEEEEEEEEEEEEEEEEEEEEEEEaaabbbbbuuuuuuuuuuuNNNNNuuuuuuuuuuuuuuuuuuuuuuuuuuuuuuuuuuuuuuuuuuuuNNNNNNNNNNNNNNNNNNNuuuuuuu
EEEEEEEEEEEEEEEEEEEEEEEEEEaaabbbuuuuuuuuuuuuuNNNuuuuuuuuuuuuuuuuuuuuuuuuuuuuuuuuuuuuuuuuuuuuuuuNNNNNNNNNNNNNNNNuuuuuuuuu
EEEEEEEEEEEEEEEEEEEEEEEEEEaaauuuuuuuuuuuuuuuNNNuuuuuuuuuuuuuuuuuuuuuuuuuuuuuuuuuuuuuuuuuuuuuuuuuuNNNNNuuuuuuuuuuuuuuuuuu
EEEEEEEEEEEEEEEEEEEEEEEEEEaaauuuuuuuuuuuuuuuNNNuuuuuuuuuuuuuuuuuuuuuuuuuuuuuuuuuuuuuuuuuuuuuuuuuuNNNNuuuuuuuuuuuuuuuuuuu
EEEEEEEEEEEEEEEEEEEEEEEEEEaaauuuuuuuuuuuuuuuNNuuuuuuuuuuuuuuuuuuuuuuuuuuuuuuuuuuuuuuuuuuuuuuuuuuuNNNNuuuuuuuuuuuuuuuuuuu
EEEEEEEEEEEEEEEEEEEEEEEEEEaaauuuuuuuuuuuuuuuNNuuuuuuuuuuuuuuuuuuuuuuuuuuuuuuuuuuuuuuuuuuuuuuuuuuuNNNuuuuuuuuuuuuuuuuuuuu
EEEEEEEEEEEEEEEEEEEEEEEEEEaaauuuuuuuuuuuuuuuNNuuuuuuuuuuuuuuuuuuuuuuuuuuuuuuuuuuuuuuuuuuuuuuuuuuuNNNuuuuuuuuuuuuuuuuuuuu
EEEEEEEEEEEEEEEEEEEEEEEEEEaaauuuuuuuuuuuuuuuNNuuuuuuuuuuuuuuuuuuuuuuuuuuuuuuuuuuuuuuuuuuuuuuuuuuuNNNuuuuuuuuuuuuuuuuuuuu
EEEEEEEEEEEEEEEEEEEEEEEEEtaauuuuuuddddddddduNNuuddddddddddddddddddddddddddddddddddddddddddddddduuNNNuddddddddduuuuuuuuuu
EEEEEEEEEEEEEEEEEEEEEEEEEtaauuuuuuduuuuuuuuuNNuuuuuuuuuuuuuuuuuuuuuuuuuuuuuuuuuuuuuuuuuuuuuuuuuuuNNNuuuuuuuuuduuuuuuuuuu
EEEEEEEEEEEEEEEEEEEEEEEEEtaauuuuuuduuhhhhhhuNNuuuhhhhhhhhhhhhhhhhhhhhhhhhhhhhhhhhhhhhhhhhhuuuuuuNNNuuuuuuuuuuduuuuuuuuuu
EEEEEEEEEEEEEEEEEEEEEEEEttaauuuuuuduuhDDDDhuNNuuuhDDDDDDDDDDDDDDDDDDDDDDDDDDDDDDDDDDDDDDDhuuuuuuNNNuuuuuuuuuuduuuuuuuuuu
EEEEEEEEEEEEEEEEEEEEEEEEtttauuuuuuduhhDDDDDNNNuuuhDDDDDDDDDDDDDDDDDDDDDDDDDDDDDDDDDDDDDDDhuuuuuuNNNuuuuuuuuuuduuuuuuuuuu
EEEEEEEEEEEEEEEEEEEEEEEEtttauuuuuuduhDDDDDhuNNuuuhDDDDDDDDDDDDDDDDDDDDDDDDDDDDDDDDDDDDDDDhuuuuuuNNNuuuuuuuuuuduuuuuuuuuu
EEEEEEEEEEEEEEEEEEEEEEEEtttauuuuuuduhDDDDDhuNNuuuhDDDDDDDDDDDDDDDDDDDDDDDDDDDDDDDDDDDDDDDhuuuuuuNNNuuuuuuuuuuduuuuuuuuuu
EEEEEEEEEEEEEEEEEEEEEEEEtttauuuuuuduhDDDDDhuNNuuuhDDDDDDDDDDDDDDDDDDDDDDDDDDDDDDDDDDDDDDDhuuuuuNNNuuuuuuuuuuuduuuuuuuuuu
EEEEEEEEEEEEEEEEEEEEEsssMttuuuuuuuduhDDDDDhuNNuuuhDDDDDDDDDDDDDDDDDDDDDDDDDDDDDDDDDDDDDDDhuuuuuNNNuuuuuuuuuuuduuuuuuuuuu
EEEEEEEEEEEEEEEEEEEEEsssMttuuuuuuuduhhhhhhhuNNuuuhDDDDDhhhhhhDDDhhhhhDhhhhhDDDhhhhhhDDDDDhuuuuNNNNuuuuuuuuuuuduuuuuuuuuu
EEEEEEEEEEEEEEEEEEEEEsssMttuuuuuuuduuuuuuuuuNNuuuhDDDDDhuuuuhDDDhuuuNNNuuuhDDDhuuuuhDDDDDhuuuuNNNuuuuuuuuuuuuduuuuuuuuuu
EEEEEEEEEEEEEEEEEEEEEsssMttuuuuuuuduhhhhhhhuNNNuuhhhhhhhuuuuhDDDhuuuNNNuuuhDDDhuuuuhhhhhhhuuuNNNNuhhhhhhhhuuuduuuuuuuuuu
EEEEEEEEEEEEEEEEEEEEssssMttuuuuuuuduhDDDDDhuNNNuuuuuuuuuuuuuhDDDhuuuNNNuuuhDDDhuuuuuuuuuuuuuuNNNuuhDDDDDDhuuuduuuuuuuuuu
EEEEEEsssssssssssssssssstttuuuuuuuduhDDDDDDNNNNuuuuuuuuuuuuuhhhhhuuNNNNNuuhhhhhuuuuuuuuuuuuuNNNNuuhDDDDDDhuuuduuuuuuuuuu
EGGGGGGGGGGGGGGGGGGGGGGGtttuuuuuuuduhDDDDDhuuNNuuuuuuuuuuuuuuuuuuuNNNNNNNuuuuuuuuuuuuuuuuuNNNNNuuuhDDDDDDhuuuduuuuuuuuuu
EZZZZZZZZZZZZZZZZZZZZZZZtttuuuuuuuduhDDDhhhuuNNNuuuuuuuuuuuuuNNNNNNNNNNNNNNNuuuuuNNNNNNNNNNNNNuhhhhDDDDDDhuuuduuuuuuuuuu
EzzzzzzzzzzzzzzzzzzzzzzzttthhhhhhhduhDDDhuuuuNNNNNNNNNNNNNNNNNNNNNNNNNNNNNNNNNNNNNNNNNNNNNNNuuuhDDDDDDDDDhuuuduuuuuuuuuu
EEEEEEssssssssssssssssssMtthDDDDDhduhDDDhuuuuuNNNNNNNNNNNNNNNNNNuuuuuuuuuNNNNNNNNNuuuuuuNNuuuuuhDDDDDDDDDhuuuduuuuuuuuuu
EEEEEEEEEEEEEEEEEEEEssssMtthDDDDDhduhhhhhuhhhhNuuuuuuuuuuuuuuNNNuuuuuuuuuNNNNNNuuuuuuuuuNNuuuuuhDDDDhhhhhhuuuduuuuuuuuuu
EEEEEEEEEEEEEEEEEEEEEsssttthDDDDDhduuuuuuuhDDhNuhhhhhhhhhhhhuuNNNuuuuuuuNNNNNuuuuuuuuuNNNNNNNuuhhDhhhuuuuuuuuduuuuuuuuuu
EEEEEEEEEEEEEEEEEEEEEsssttthDDDDDhduuhhhhhhDDDNuhDDDDDDDDDDhuuNNNuuuuuNNNNNuuuuuuuuuNNNNNNNNNNNuuNuuuuuuuuuuuduuuuuuuuuu
EEEEEEEEEEEEEEEEEEEEEsssttthhhDhhhduuhDDDDDDDhuuhDDDDDDDDDDhuuNNNuuuuNNNNuuuuuuuuuuNNNNNNNNNNNNNNNuuuuuuuuuuuduuuuuuuuuu
EEEEEEEEEEEEEEEEEEEEssssMttuhDDDDhduuhhDDDDDDhuuhDDDDDDDDDDhuuNNNuuuNNNuuuhhhhhuuuNNNNNNNNNNNNNNNuuuuuuuuuuuuduuuuuuuuuu
EEEEEEssssssssssssssssssMttuhDDDDhduuuhhDDDDDhuuhDDDDDDDDDDhuuNNNuuNNNuuuuhDDDhuuuNNNNNNNNNNNNNNNuuuuuuuuuuuuduuuuuuuuuu
EEEEEEssssssssssssssssssMttuhDDDDhduuuuhhhhhhhuuhhhhhDhhhhhhuuNNNuuNNNuuuuhDDDhuuNNNNNNNNNNNNNNNNNuhhhhhhhhhuduuuuuuuuuu
EEEEEEEEEEEEEEEEEEEEssssMttuhDDDDhduuuuuuuuuuuuuuuuuuNuuuuuuuNNNuuNNNNuuhhhDDDhuuNNNNNNNNNNNNNNNNNuhDDDDDDDhuduuuuuuuuuu
EEEEEEEEEEEEEEEEEEEEEsssMttuhDDDDhduuuuuuuuuNNNNNNNNNNNNNNNNNNNNNNNNNuuuhDDDDDhuuNNNNNNNNNNNNNNNNNuhDDDDDDDhuduuuuuuuuuu
EEEEEEEEEEEEEEEEEEEEEsssMttuhDDDDhduuuuuuuuNNNNNNNNNNNNNNNNNNNNNNNNNNuuuhDDDDDhuuNNNNNNNNNNNNNNNNNuhDDDDDDDhuduuuuuuuuuu
EEEEEEEEEEEEEEEEEEEEEsssMttuhDDDDhduuuuuuuuNNuuuuuuuuuuuuNuuuuuNuuNNNuuuhDDDDDhuuNNNNNNNNNNNNNNNNNuhDDDDDDDhuduuuuuuuuuu
EEEEEEEEEEEEEEEEEEEEEsssMttuhDDDDhduuuuuuuNNNuhhhhhhuuuhhDhhuhhDhhuNNuuuhDDDDDhuuNNNNNNNNNNNNNNNNNNDDDDDDDDhuduuuuuuuuuu
EEEEEEEEEEEEEEEEEEEEEsssMtttDDDDDhduuuuuuuNNuuhDDDDhuuuhDDDhuhDDDhuNNuuuhhhDhhhuuNNNNNNNNiNNNNNNNNuhDDDDDDDhuduuuuuuuuuu
EEEEEEEEEEEEEEEEEEEEEsssMttuhDDDDhduuuuuuuNNuuhDDDDhuuuhDDDhuhDDDhuNNNuuuuuNuuuuuNNNNNNNNNNNNNNNNNuhhhhhhhhhuduuuuuuuuuu
EEEEEEEEEEEEEEEEEEEEEsssMttuhDDDDhduuuuuuuNNuuhDDDDhhhuhDDDhuhDDDhuNNNNNNNNNNNNNNNNNNNNNNNNNNNNNNNuuuuuuuuuuuduuuuuuuuuu
EEEEEEEEEEEEEEEEEEEEEsssMttuhhhhhhduuuuuuuNNuuhDDDDDDhuhDDDhuhDDDhuNNNNNNNNNNNNNNNNNNNNNNLNNNNNNNNuuuuuuuuuuuduuuuuuuuuu
EEEEEEEEEEEEEEEEEEEEEsssMttuuuuuuuduuuuuuuNNuuhDDDDDDhuhDDDhuhDDDhuNNNuuuuuuuuuuuNNNNNNNNNNNNNNNNNuhhhhhhhhhuduuuuuuuuuu
EEEEEEEEEEEEEEEEEEEEEsssMttuuuuuuuduuuuuuuNNuuhDDDDDDhuhDDDhuhDDDhuNNNuhhhhhhhhhuNNNNNNNNNNNNNNNNNuhDDDDDDDhuduuuuuuuuuu
EEEEEEEEEEEEEEEEEEEEEsssMttuuuuuuuduuuuuuuNNuuhhhhhDhhuhhhhhuhhhhhuNNuuhDDDDDDDhuNNNNNNNNNNNNNNNNNNDDDDDDDDhuduuuuuuuuuu
EEEEEEEEEEEEEEEEEEEEssssMttuuuuuuuduuuuuuNNNNuuuuuuNuuuuuuuuuuuuuuNNNNNDDDDDDDDhuNNNNNNNNNNNNNNNNNuhDDDDDDDhuduuuuuuuuuu
EEEEEEsssssssssssssssssstttNNNNNNNNNNNNNNNNNNNNNNNNNNNNNNNNNNNNNNNNNNuuhDDDDDDDhuNNNNNNNNNNNNNNNNNuhDDDDDDDhuduuuuuuuuuu
EEEEEEsssssssssssssssssstttNNNNNNNNNNNNNNNNNNNNNNNNNNNNNNNNNNNNNNNNNuuuhDDDDDDDhuNNNNNNNNNNNNNNNNNuhDDDDDDDhuduuuuuuuuuu
EEEEEEEEEEEEEEEEEEEEssssMttuuuuuuuduuuuuNNNNNNuuuuuuuuuuuuuuuuuuuuNNuuuhDDDDDDDhuNNNNNNNNNNNNNNNNNuhDDDDDDDhuduuuuuuuuuu
EEEEEEEEEEEEEEEEEEEEEsssMttuuuuuuuduuuuuuNNNNuuuuhhhhhhhhhhhhhhhuuNNuuuhDDDDDDDhuNNNNNNNNNNNNNNNNNuhhhhhhhhhuduuuuuuuuuu
EEEEEEEEEEEEEEEEEEEEEsssMttuuuuuuuduuuuuuuNNuuuuuhDDDhDDDhDDDDDhuuNuuuuhDDDDDDDhuuNNNNNNNNNNNNNNNuuuuuuuuuuuuduuuuuuuuuu
EEEEEEEEEEEEEEEEEEEEEsssMttuuuuuuuduuhhhhuNNuuuuuhDDDhDDDhDDDDDhuNNuuuuhhhhDDDDhuuNNNNNNNNNNNNNNNuuuuuuuuuuuuduuuuuuuuuu
EEEEEEEEEEEEEEEEEEEEEsssMttuuuuuuuduhhDDhuNNuuuuuhDDDhDDDhDDDDDhuNNuuuuuuuhDDDDhuuuNNNNNNNNNNNNNuuuuuuuuuuuuuduuuuuuuuuu
EEEEEEEEEEEEEEEEEEEEEsssMttuuuuuuuduhDDDDNNNuuuuuhhDhhhDhhDDDDDhuNNuuuuuuuhDDDDhuuuuNNNNNNNNNNNuuuuuuuuuuuuuuduuuuuuuuuu
EEEEEEEEEEEEEEEEEEEEEsssMttuuuuuuuduhDDDhuNNuuuuuhDDDDDDDDDDDDDDNNNuuuuuuuhhhhhhuuuuuuNNNNNNNuuuuuuuuuuuuuuuuduuuuuuuuuu
EEEEEEEEEEEEEEEEEEEEEsssMttuuuuuuuduhDDDhuNNuuuuuhhDhhhDhhDDDDDhuNNNNNNuuuuuuuuuuuuuuuuuNNuuuuuuuuuuuuuuuuuuuduuuuuuuuuu
EEEEEEEEEEEEEEEEEEEEEsssMttuuuuuuuduhDDDhuNNuuuuuhDDDhDDDhDDDDDhuNNuhhDhhhhhhuuuuuuuuuuuNNuuuuuuuuuuuuuuuuuuuduuuuuuuuuu
EEEEEEEEEEEEEEEEEEEEEsssMttuuuuuuuduhDDDhuNNuuuuuhDDDhDDDhDDDDDhuNNuhDDDDDDDhuuuhhhhhuuuNNuuuuuuuuuuuuuuuuuuuduuuuuuuuuu
EEEEEEEEEEEEEEEEEEEEEsssMttuuuuuuuduhDDDhuNNuuuuuhDDDhDDDhDDDDDhuNNuhDDDDDDDhuuuhDDDhuuNNNuuuuuuuuuuuuuuuuuuuduuuuuuuuuu
EEEEEEEEEEEEEEEEEEEEEsssMttuuuuuuuduhhDDhuNNuuuuuhhhhhhhhhDDDDDhuNNuhDDDDDDDhuuuhDDDDNNNNNuuuuuuuuuuuuuuuuuuuduuuuuuuuuu
EEEEEEEEEEEEEEEEEEEEssssMttuuuuuuuduuhhhhuNNuuuuuuuhDDDDDhDDDDDhuNNuhhhhDDDDhuuuhDDDhuuNNNuuuuuuuuuuuuuuuuuuuduuuuuuuuuu
EEEEEEssssssssssssssssssMttuuuuuuuduuuuuuuNNuuuuuuuhDDDDDhDDDDDhuNNuuuuhDDDDhuuuhDDDhuuNNuuuuuuuuuuuuuuuuuuuuduuuuuuuuuu
EEEEEEssssssssssssssssssMttuuuuuuuduuuuuuuNNuuuuuuuhDDDDDDDDDDDhuNNuuuuhhhhhhuuuhDDDhuuNNuuuuuuuuuuuuuuuuuuuuduuuuuuuuuu
EEEEEEEEEEEEEEEEEEEEssssMttuuuuuuuduhhhhhuNNNuuuuuuhDDDDDhDDDDDhuNNuuuuuuuuuuuuuhhhhhuNNNuuuuuuuuuuuuuuuuuuuuduuuuuuuuuu
EEEEEEEEEEEEEEEEEEEEEssstttuuuuuuuduhDDDhuNNNuuuuuuhDDDDDhDDDDDhuNNuuuuuuhhhhhuuuuuuuuNNuuuuuuuuuuuuuuuuuuuuuduuuuuuuuuu
EEEEEEEEEEEEEEEEEEEEEssstttuuuuuuuduhDDDDNNNNuuuuuuhhhhhhhhhhhhhuNNuuuuuuhDDDhuuuuuuuNNNuhhhhhhuuuuuuuuuuuuuuduuuuuuuuuu
EEEEEEEEEEEEEEEEEEEEEssstttuuuuuuuduhDDDhuNNNNuuuuuuuuuuuuuuuuuuuNNuuuuuuhDDDhuuuuuuuNNuuhDDDDhuuuuuuuuuuuuuuduuuuuuuuuu
EEEEEEEEEEEEEEEEEEEEssssMttuuuuuuuduhDDDhuuNNNuuuuuuuuuuuuuuuuuuuNNuuhhhhhDDDhuuuuuuNNNuuhDDDDhuuuuuuuuuuuuuuduuuuuuuuuu
EEEEEEssssssssssssssssssMttuuuuuuuduhDDDhuuuNNNuuuuuuuuuuuuuuuuuuNNuuhDDDDDDDhuuuuuNNNuuhhDDDDhuuuuuuuuuuuuuuduuuuuuuuuu
EGGGGGGGGGGGGGGGGGGGGGGGtttuuuuuuuduhDDDhhhhuNNNuuuuuuuuuuuuuuuuuNNuuhDDDDDDDhuuuuNNNuuuhDDDDDhuuuuuuuuuuuuuuduuuuuuuuuu
EZZZZZZZZZZZZZZZZZZZZZZZtttuuuuuuuduhDDDDDDhuuNNNuuuuuuuuuuuuuuuNNNuuhDDDDDDDhuuuNNNuuuhhDDDDDhuuuuuuuuuuuuuuduuuuuuuuuu
EzzzzzzzzzzzzzzzzzzzzzzztttuuuuuuuduhDDDDDDhuuuNNNNNuuuuuuuuuuuNNNNuuhDDDDDDDhuuNNNuuuuhDDDDDDhuuuuuuuuuuuuuuduuuuuuuuuu
EEEEEEsssssssssssssssssstttuuuuuuuduhDDDDDDhuuuNNNNNNNNNNNNNNNNNNNNNuhhDhhhhhhuNNNuuuuuhDDDDDDhuuuuuuuuuuuuuuduuuuuuuuuu
EEEEEEEEEEEEEEEEEEEEssssMttuuuuuuuduhDDDDDDhuuuNuuNNNNNNNNNNNNNNNNNNuuuNuuuuuuNNNuuuuuuhDDDDDDhuuuuuuuuuuuuuuduuuuuuuuuu
EEEEEEEEEEEEEEEEEEEEEsssMttuuuuuuuduhDDDDDDhuuuNuuuuuuNuuuuNNNuNNNNNNNuNuuuuNNNNuuuuuuuhhDhhhhhuuuuuuuuuuuuuuduuuuuuuuuu
EEEEEEEEEEEEEEEEEEEEEsssMttuuuuuuuduhhhhhhhhuhhDhhuuuhDhhuuuNuuuuuNNNNNNNNNNNNNuuuuuuuuuuNuuuuuuuuuuuuuuuuuuuduuuuuuuuuu
EEEEEEEEEEEEEEEEEEEEEsssMttuuuuuuuduuuuuuuuuuhDDDhuuhhDDhuhhDhhuuuuuNNNNNNNNNNNNNNNNNNNNNNNNNNNNNNNuuuuuuuuuuduuuuuuuuuu
EEEEEEEEEEEEEEEEEEEEEsssMttuuuuuuuduuuuuuuuuuhDDDhuuhDDDhuhDDDhhuuuuNNNNNNNNNNNNNNNNNNNNNNNNNNNNNNNNNNuuuuuuuduuuuuuuuuu
EEEEEEEEEEEEEEEEEEEEEEEEMttuuuuuuuduuuuuuuuuuhDDDhuuhDDDhuhDDDDhuuuuuNNNNNuuuuuuuuuuuuuuuuuuNNNNNNNNNNuuuuuuuduuuuuuuuuu
EEEEEEEEEEEEEEEEEEEEEEEEMttuuuuuuuduuuuuuuuuuhDDDhuuhhhhhuhDDDDhuuuuuNNNuuuuuuuuuuuuuuuuuuuuuuuuuuuuuuuuuuuuuduuuuuuuuuu
EEEEEEEEEEEEEEEEEEEEEEEEMttuuuuuuuduuuuuuuuuuhhhhhuuuuuuuuhhDDDhuuuuuNNuuuuuuuuuuuuuuuuuuuuuuuuuuuuuuuuuuuuuuduuuuuuuuuu
EUEEEEEEEEEEEEEEEEEEEEEEMttuuuuuuuduuuuuuuuuuuuuuuuuuuuuuuuhhhhhuuuuuNNuuuuuuuuuuuuuuuuuuuuuuuuuuuuuuuuuuuuuuduuuuuuuuuu
EEEEEEEEEEEEEEEEEEEEEEEEMttuuuuuuuduuuuuuuuuuuuuuuuuuuuuuuuuuuuuuuuuuNNuuuuuuuuuuuuuuuuuuuuuuuuuuuuuuuuuuuuuuduuuuuuuuuu
EEEEEEEEEEEEEEEEEEEEEEEEMttuuuuuuudddddddddddddddddddddddddddddddddduNNudddddddddddddddddddddddddddddddddddddduuuuuuuuuu
EEEEEEEEEEEEEEEEEEEEEEEEMttuuuuuuuuuuuuuuuuuuuuuuuuuuuuuuuuuuuuuuuuuuNNuuuuuuuuuuuuuuuuuuuuuuuuuuuuuuuuuuuuuuuuuuuuuuuuu
EEEEEEEEEEEEEEEEEEEEEEEEQppuuuuuuuuuuuuuuuuuuuuuuuuuuuuuuuuuuuuuuuuuuNNuuuuuuuuuuuuuuuuuuuuuuuuuuuuuuuuuuuuuuuuuuuuuuuuu
EEEEEEEEEEEEEEEEEEEEEEEEEEuuuuuuuuuuuuuuuuuuuuuuuuuuuuuuuuuuuuuuuuuuuNNuuuuuuuuuuuuuuuuuuuuuuuuuuuuuuuuuuuuuuuuuuuuuuuuu
EEEEEEEEEEEEEEEEEEEEEEEEEEEEuuuuuuuuuuuuuuuuuuuuuuuuuuuuuuuuuuuuuuuuNNNuuuuuuuuuuuuuuuuuuuuuuuuuuuuuuuuuuuuuuuuuuuuuuuuu
EEEEEEEEEEEEEEEEEEEEEEEEEEEEEEEEEEEEEEEuuuuuuuuuuuuuuuuuuuuuuuuuuuuuNNuuuuuuuuuuuuuuuuuuuuuuuuuuuuuuuuuuuuuuuuuuuEEEEEEE
EEEEEEEEEEEEEEEEEEEEEEEEEEEEEEEEEEEEEEEEEEEEEEEEEuuuuuuuuuuuuuuuuuuuNNuuuuuuuuuuuuuuuuuuuuuuuuuEEEEEEEEEEEEEEEEEEEEEEEEE
EEEEEEEEEEEEEEEEEEEEEEEEEEEEEEEEEEEEEEEEEEEEEEEEEEEEEEEEEEEuuuuuuuuuVVuuuuuuuuuuEEEEEEEEEEEEEEEEEEEEEEEEEEEEEEEEEEEEEEEE
EEEEEEEEEEEEEEEEEEEEEEEEEEEEEEEEEEEEEEEEEEEEEEEEEEEEEEEEEEEEEEEEEEEEVVEEEEEEEEEEEEEEEEEEEEEEEEEEEEEEEEEEEEEEEEEEEEEEEEEE
EEEEEEEEEEEEEEEEEEEEEEEEEEEEEEbbbbbbbEEEEEEEEEEEEEEEEEEEEEEEEEEEEEEEVVEEEEEEEEEEEEEEEEEEEEEEEEEEEEEEEEEEEEEEEEbbbbbbbbbb
EEEEEEEEEEEEEEEEEEEEEEEEEEEEbbbbbbbbbbbbbbbbbbbbbbbEEEEEEEEEEEEEEEEEVVEEEEEEEEEEEEEEEEEEEEEEbbbbbbbbbbbbbbbbbbbbbbbbbbbb
EEEEEEEEEEEEEEEEEEEEEEEEEEbbbbbbbbbbbbbbbbbbbbbbbbbbbbbbbbbbbbEEEEEEVVEEEEEEEEbbbbbbbbbbbbbbbbbbbbbbbbbbbbbbbbbbbbbbbbbb
EEEEEEEEEEEEEEEEEEEEEEEEEbbbbbbbbbbbbbbbbbbbbbbbbbbbbbbbbbbbbbbbbbbbVVbbbbbbbbbbbbbbbbbbbbbbbbbbbbbbbbbbbbbbbbbbbbbbbbbb
EEEEEEEEEEEEEEEEEEEEEEEEEbbbbbbbbbbbbbbbbbbbbbbbbbbbbbbbbbbbbbbbbbbbbbbbbbbbbbbbbbbbbbbbbbbbbbbbbbbbbbbbbbbbbbbbbbbbbbbb
EEEEEEEEEEEEEEEEEEEEEEEEbbbbbbbbbbbbbbbbbbbbbbbbbbbbbbbbbbbbbbbbbbbbbbbbbbbbbbbbbbbbbbbbbbbbbbbbbbbbbbbbbbbbbbbbbbbbbbbb
EEEEEEEEEEEEEEEEEEEEEEEEbbbbbbbbbbbbbbbbbbbbbbbbbbbbbbbbbbbbbbbbbbbbbbbbbbbbbbbbbbbbbbbbbbbbbbbbbbbbbbbbbbbbbbbbbbbbbbbb
EEEEEEEEEEEEEEEEEEEEEEEEbbbbbbbbbbbbbbbbbbbbbbbbbbbbbbbbbbbbbbbbbbbbbbbbbbbbbbbbbbbbbbbbbbbbbbbbbbbbbbbbbbbbbbbbbbbbbbbb
EEEEEEEEEEEEEEEEEEEEEEEEbbbbbbbbbbbbbbbbbbbbbbbbbbbbbbbbbbbbbbbbbbbbbbbbbbbbbbbbbbbbbbbbbbbbbbbbbbbbbbbbbbbbbbbbbbbbbbbb
EEEEEEEEEEEEEEEEEEEEEEEEbbbbbbbbbbbbbbbbbbbbbbbbbbbbbbbbbbbbbbbbbbbbbbbbbbbbbbbbbbbbbbbbbbbbbbbbbbbbbbbbbbbbbbbbbbbbbbbb
EEEEEEEEEEEEEEEEEEEEEEEEbbbbbbbbbbbbbbbbbbbbbbbbbbbbbbbbbbbbbbbbbbbbbbbbbbbbbbbbbbbbbbbbbbbbbbbbbbbbbbbbbbbbbbbbbbbbbbbb
"}
